################################
#0000000000000100000#0000000000#
#0000000000000000000#00000000X0#
#0000000000000000000#0000000000#
#000#####000#####000#0000000001#
#000#001000000#00000#0000000000#
#000#000000000#00000#0000000000#
#000#000000000#00000#0000000001#
#100#000#######10001#0000000000#
#000#000000000#00000#0000000000#
#000#0P0000001#00000#0000000000#
#000#000000000#00000#0000000000#
#000###########00000####0000####
#000#000010000##000#####0000####
#0000000000000000000#0000000000#
#0000000000000000000#0000000000#
#0000000000000000000#0000000000#
#000#000010000#00000#0000000000#
###############00000######000###
#0001000000000#00000#0010000000#
#000000000000000000000000000000#
#000000000000000000000000000000#
#000000000000000000000000000000#
################################
