##############################
#0000000000000100000#000000000
#0000000000000000000#00000000X
#0000000000000000000#000000000
#000#####000#####000#000000000
#000#001000000#00000#000000000
#000#000000000#00000#000000000
#000#000000000#00000#000000000
#100#000#######10001#000000000
#000#0000S0000#00000#000000000
#000#0.0000P01#00000#000000000
#000#000000000#00000#000000000
#000###########00000####0000##
#000#000010000##000#####0000##
#0000000000000000000#000000000
#0000000000000000000#000000000
#0000000000000000000#000000000
#000#000010000#00000#000000000
###############00000######000#
#0001000000000#00000#001000000
