###############################
#.....#..S..#.....#..1..#..1..#
#.P...............#.....#.....#
#................1#.....#.....#
#1................#.....#.....#
#.....#.....#.....#.....#.....#
##...#########...###...###...##
#.....#..1..#.....#.....#.....#
#...........#.................#
#1..........#................1#
#...........#...........1.....#
#.....#.....#..1..#.....#.....#
########...########.....##...##
#..1..#.....#.....#.....#.....#
#...........#...........#.....#
#...........#..S.......1#....1#
#...........#...........#..X..#
#.....#..1..#.....#.....#.....#
###############################
